1111111111111111111111111111111
1000P00000000000000000000100001
10000000010000000C000E000000001
1000000001000000000000000111111
1000000000000000000000000000001
1000000001000000000000000000001
1000P00C0100000C000000000000001
1111111111111111111111111111111
1111111111111111111111111111111
1000P00001000000000000000100001
10000000010000000C000E000000001
1000000000000000000000000111111
1000000001000000000000000000001
1000000001000000000000000000001
1000000C0000000C000000000000001
1111111111111111111111111111111