1111111111111111111111111111111
1001P10000000000010000000100001
10000000010000000C100E000000001
1000000001000000010000000111111
1000000000000000000000000000001
1000000001000001000000000000001
1000000C0100001C000000000000001
1111111111111111111111111111111