11111111111
1P000000C11
10000000C01
10000000001
100000E0001
111111C1111
11111111111