1111111111111111111111111111111
1000P00000000000010000000100001
10000000000000000C100E000000001
1000000001000000010000000111111
1000000000000000000000000000001
1000000111000001000000000000001
10000000C100001C000000000000001
1111111111111111111111111111111