1111111111111111111111111
1P000000E000C00000C000001
1010000000001101001010101
1010010101010001000010101
100000C00C0000000000000C1
1111111111111111111111111